album count: 293
1-2: olive
3-4: yellow
5-6:orange
7-8:red
9-10: maroon
-------------------------------------------------------------------------
10/10: 48
2 0 2 1 - reverie
alvvays - blue rev
astromeda - holding a stranger's hand
astromeda - these situations
asunojokei - island
ayane yamazaki - 魂のハイウェイ (the highway of truth)
bala desejo - sim sim sim
beabadoobee - beatopia
beach house - once twice melody
big thief - dragon new warm mountain i believe in you
billy woods - aethiopes
binker golding - dream like a dogwood wild boy
black country, new road - ants from up there
candy - heaven is here
caroline loveglow - strawberry
chat pile - god's country
cmat - if my wife new i'd be dead
cool maritime - big earth energy
dj crackwire - plays the hits
ethel cain - preacher's daughter
florist - florist
guppy - guppyloid: world tour
iano - life cycles
iv and the strange band - southern circus
jenny hval - classic objects
jyocho - lets promise to be happy
kaitlyn aurelia smith / emile mosseri - i could be your dog / i could be your moon
kali malone - living torch
kalia vandever - regrowth
kinoteki - human noise
moonchild - starfruit
motifs - remember a stranger
naked flames - miracle in transit
natalia lafourcade - de todas las flores
noah grigoroff - drown cycle EP
perfume genius - ugly season
petrol girls - baby
the poles - the high tide club
renata zeiguer - picnic in the dark
say sue me - the last thing left
silvana estrada - marchita
sobs - air guitar
sun is poison - i thought i left you in eden
tapani rinne / juna maki-pastola - open
turquoisedeath - paint the world blue
vitesse x - us ephemeral
wednesday - mowing the leaves instead of piling em up
xaev - berdlycore chapter 2
-------------------------------------------------------------------------
9/10: 57
the 1975 - being funny in a foreign language
arthur king - koyaanisqatsi EP
asian glow / weatherday - weatherglow ep
atom eyes - blue into gold
barney mcall - precious energy
ben mcelroy - how i learnt to disengage from the pack
billy woods - church
bjork - fossora
brown calvin - d i m e n s i o n // p e r s p e c t i v e
causeway - we were never lost
charlotte agidery / bolis pupul - topical dancer
cheryl leonard - music from the ice
daniel avery - ultra truth
dieudonne - starkiller
dj re:code - recodepop!
dynastic - i know there's something left for you
ebi soda - honk if you're sad
ego ella may - fieldnotes pt ii
emile parisien - louise
gabuislost - partners
gea - daisies for ears
hatchie - giving the world away
the howard hughes suite - high & lonesome
inframell0w - cl0uds
iamrw - that summer when we met
if i promise - somatic
jacob banks - lies about the war
jamie drake - new girl
jid - the forever story
jockstrap - i love you jennifer b
joel ross - the parable of the poet
jonny tobin - together
joyce moreno - brasileiras canções
kaitlyn aurelia smith - let's turn it into sound
lucy roleff / lehmann b. smith - dark green
marxist love disco ensemble - mlde
mj lenderman - boat songs
more eaze - oneiric
natalie evans - movements
nduduzo makhathini - in the spirit of ntu
otoboke beaver - super champon
parannoul - white ceiling / black dots wandering around EP
paul cherry - back on the music!
perfume - plasma
pinegrove - 11:11
pup - the unraveling of puptheband
rachika nayar - heaven come crashing
rain recordings - artificial rain
revelators sound system - revelators
ross jenkins - free all day
sault - air
sharon van etten - we've been going about this all wrong
sonhos tomam conta - maladaptive daydreaming
sooner - days and nights
space between clouds - space between clouds
sweaty lamarr - a little bit cuntry, a little bit rock & roll
tim bernardes - mi coisas invisiveis
-------------------------------------------------------------------------
8/10: 110
ada rook - ugly death no redemption angel curse i love you
aldous harding - warm chris
alphabet holds hostage - again and so soon
angel olsen - big time
antoine berjeaut - chromesthesia
argo nuff / blood estate - bigcity // brightlights
asian glow - stalled flutes, means
astronoid - radiant bloom
anxious - little green house
bad breeding - human capital
bad bunny - un verano sin ti
band of horses - things are great
bedlocked - bedlocked
benny the butcher - tana talk iiii
black midi - hellfire
broods - space island
caytra - caytra EP
cecile mclorin-salvant - ghost song
chance de la soul - no new music
charlie lomonaco - no smiles no laughter
claire dickson - starland
combo chimbita - ire
denzel curry - melt my eyez see your future
deserta - every moment, everything you need
drive-by truckers - welcome 2 club xiii
druida - limnociclo
east portal - east portal
elucid - i told bessie
erin rae - lighten up
espen eriksen trio - in the mountains
etran de l'air - agadez
faretheewell - i hate it here
fka twigs - caprisongs
fkj - v i n c e n t
flacco's bizzare adventure - sugar ~ shit ~ silk ~ sweat
flasher - love is yours
fly anakin - frank
fontaines d.c. - skinty fia
foxtails - fawn
freddie gibbs -
fresh pepper - fresh pepper
fulband. - illicit mix
gabuislost - friends
ginger root - nisemono EP
guerilla toss - famously alive
hey ily - psychokinetic love songs
i like to sleep - sleeping beauty
iano - nothing special court
if i promise - in the form of light
joan shelley - the spur
just mustard - heart under
katy j pearson - sound of the morning
kelly lee owens - lp.8
kojey radical - reason to smile
julius rodriguez - let sound tell all
lask - b15muth
launder - happening
let's eat grandma - two ribbons
makeout palace - the midnight show
mary halvorson - amaryllis
maylee todd - maloo
melisa - zasługuję na istnienie
melissa aldana - 12 stars
melody's echo chamber - emotional eternal
miguel otero - brief tales
moondaughter - phosphenes and iridescent lights
moor mother - jazz codes
nicki bluhm - avondale drive
orville peck - bronco
overmono - cash romantic EP
patrick watson - better in the shade
prince daddy & the hyena - prince daddy & the hyena
quiet commotion - all others strange
ravyn lenae - hypnos
the reds, pinks and purples - summer at land's end
rei brown - xeno
rico nasty - las ruinas
roc marciano / the alchemist - the elephant man's bones
ruby - concerns people have about me...
ruby - sonic aftermath
ruby - sonic sanctum
sarah kinsley - cypress EP
salamanda - ashbalkum
sally shapiro - sad cities
satin sheets - st. francis ii
shaylee - short-sighted security
silvia tarozzi / deborah walker - canti di guerra, di lavoro e d'amore
soul glo - diaspora problems
sound of ceres - emerald sea
spacemoth - no past no future
spinn - outside of the blue
sxdshxwty - rejuvenator
stella donnelly - flood
tess roby - ideas of space
tomo nakaguchi - tayutau
tony bontana - p.o.v (deluxe)
tony bontana - tony thom 2022
tony shhnow - reflexions
trish (quiet commotion) - dead herrings
tumi morogosi - group theory: black music
vega trails - tremors in the static
vince staples - ramona park broke my heart
vylet pony - can opener's notebook: fish whisperer
wake - thought form descent
walter smith / matthew stevens - in common iii
the weather station - how is it that i should look at the stars
wet leg - wet leg
wormrot - hiss
xenia franca - em nome da estrela
yeule - glitch princess
-------------------------------------------------------------------------
7/10: 41
18 days - 日が続く m e l i s s a
adrian quesada - boleros psicodelicos
american aquarium - chicomacomico
arthur king - changing landscapes (mina las pintadas)
axel boman - quest for fire
blutch - terre promise
carter c - the things i love and why i love them
chance de la soul - shine on
daniel rossen - you belong here
deer scout - woodpecker
dehd - blue skies
diane coffee - with people
diplo - diplo
domi & jd beck - not tight
father john misty - chloe and the next 20th century
garrett atterberry / the arizon - the 33rd dimension
gea - king bird ep
high pulp - pursuit of ends
iano - there's no river
ibibio sound machine - electricity
khruangbin / leon bridges - texas moon EP
jordana - face the wall
king gizzard and the lizard wizard - changes
king gizzard and the lizard wizard - ice, death, planets, lungs, mushrooms and lava 
lupe fiasco - drill music in zion
my warm blood - behind closed doors
maren morris - humble quest
marn halvorson - belladonna
michaela anne - oh to be that free
nachi - reboot
partner look - by the book
patricia taxxon - wax under wolcnum
peach pit - from 2 to 3
redveil - learn 2 swim
ruby - sonic science
saba - few good things
sheldon agwu - seeds of sanctum vol 2
soak - if i never know you like this again
soccer mommy - sometimes, forever
spoon - lucifer on the sofa
terreyl fields - we aren't over EP
-------------------------------------------------------------------------
6/10: 14
aurora - the gods we can touch
beach bunny - emotional creature
bladee / ecco2k - crest
camp cope - running with the hurricane
cloakroom - dissolution wave
immanuel wilkins - the 7th hand
julia jacklin - pre pleasure
king gizzard and the lizard wizard - omnium gatherum
luna li - cherry
mistki - laurel hell
raveena - asha's awakening
rex orange county - who cares?
shamir - heterosexuality
westside gunn - peace "fly god"
-------------------------------------------------------------------------
5/10: 5
animal collective - time skiffs
boris - w
earl sweatshirt - sick!
florence and the machine - dance fever
mxmtoon - rising
-------------------------------------------------------------------------
4/10: 10
axel boman - luz
cate le bon - pompeii
cities aviv - man plays the horn
haru nemuri - shunka ryougen
muna - muna
pusha t - its almost dry
spritualized - everything was beautiful
steve lacy - gemini rights
toro y moi - mahal
wallows - tell me that its over
-------------------------------------------------------------------------
3/10: 4
duster - together
nilufer yanya - painless
rosalia - motomami
the weeknd - dawn fm
-------------------------------------------------------------------------
2/10: 4
070 shake - you can't kill me
charli xcx - crash
harry styles - harry's house
post malone - twelve carat toothache
-------------------------------------------------------------------------
1/10: 1
viagra boys - cave world
-------------------------------------------------------------------------
0/10: 1
jack harlow - come home the kids miss you